%%%%%%%%%%%%%%%%%%%%%%%%%%%%%%%%%%%%%
%                       % %   % %   %
% %                   %%% % %%% %%% %
%                     %     % % %   %
%%%                   %%% %%% % % % %
%                     % %   %     % %
% % %                     %%% %%% % %
% % %     % % % % %     %   % % % % %
% % % %%%%%%% % %%%%%%%%% %%% % %%% %
% % % %     %   %     %     %   %   %
%%% % %             % %%% %%% %%%%% %
%     % % %     % %     % %   % % % %
% % % % % %%% %%% %%% %%% % % % % % %
% % % % %                 % % %     %
%%% %%% % % % % %%%%% %%% % %%% %%%%%
%     % % % % %     %   %     % %   %
%%%%% % % %%%%%%%%% %%%%%%%%%%% % %%%
%     %           % %     %   % %   %
% %%% %%%%% %%%%%%%%% %%%%% % % %%% %
% %   %      %        %     %       %
% % % %%%%% %%% % % % % %%%%%%%%%%%%%
% % %   %   % % % % %       %   % % %
% % %%% %%% % % % %         %%% % % %
% %   % %   % % %   % %   % % %     %
% %%%   %   %                 % %%%%%
%   %   %   %     % %     %   % %   %
%%% % %%%%% %%%%% %%% %%% % %%% % %%%
%.% % % % % % %     % %   % %   % % %
% % %   %   %             % % % % % %
%   %   %   %                 %     %
% % % % %%% %%% %%%%%%% %%% %%% %%% %
% % % %       %   %       %   % %  P%
%%%%%%%%%%%%%%%%%%%%%%%%%%%%%%%%%%%%%