%%%%%%%%%%%
%.  . %ooo%
% %%.%%o% %
%ooooooo% %
%o%% % %% %
%P    .   %
%%%%%%%%%%%