%%%%%%%%%
%.  . % %
%o%%. % %
%o o P%.%
%ooo    %
%%%%%%%%%