%%%%%%%%%%%%%%%%%%%%%%
% %%        % %     P%
%    %%%%%% % %%%%%% %
%%%%%%               %
%                %%%%%
% %%             %   %
%        %%% %%%   % %
%%%%%%%%%%    %%%%%% %
%.         %%        %
%%%%%%%%%%%%%%%%%%%%%%