%%%%%%%%%
%      P%
%       %
%  %  % %
%%%%  %%%
%.      %
%%%%%%%%%
